sinath	sinath	1
amariss	amariss	1
thyrome	thyrome	1
leiona	leiona	1
delantae	delantae	1
nohl	nohl	1
gaddiel	gaddiel	1
durl	durl	1
melo	melo	1
colon	colon	1
saratha	saratha	1
caprina	caprina	1
evolett	evolett	1
rekesha	rekesha	1
jerrianna	jerrianna	1
gurshaan	gurshaan	1
finnly	finnly	1
teenamarie	teenamarie	1
madhulika	madhulika	1
kiomy	kiomy	1
